%s used of %s %s %%=%s used of %s (%s %%)
---=
Active tunnels=Tunnel attivi
Activity=Attività
ago=fa
Airflow=Flusso d'aria
All Apps=Tutte le applicazioni
All VMs=Tutte le machine virtuali
Battery charge=Carica della batteria
BIOS dated=data del BIOS
Click to toggle details=Clicca per cambiare i dettagli
Completed=Completato
Counters info=Info contatori
Current operation %s on %s=Esercizio corrente %s su **%s**
custom image=Immagine personalizzata
Data is invalid=I dati non sono validi.
default image=Immagine predefinita
Docker Containers= Container docker
Due in=Previsto fra
Elapsed time=Tempo trascorso
Errors info=Dettaglio degli errori
Estimated finish=Fine prevista
failed device=dispositivo fallito
Fan count=Conteggio ventola
FAN=Ventola
Finding %s error=Trovato: **%s** errore
Finding %s errors=Trovati: **%s** errori
General info=informazioni generali
Go to cache settings=Vai alle impostazioni della cache
Go to CPU pinning settings=Vai alle impostazioni di affinità CPU
Go to disk settings=Vai alle impostazioni del disco
Go to Docker settings=Vai alle impostazioni docker
Go to fan settings=Vai alle impostazioni ventola
Go to identification settings=Vai alle impostazioni di identificazione
Go to network settings=Vai alle impostazioni di rete
Go to scheduler settings=Vai alle impostazioni dello scheduler
Go to Share settings=Vai a Impostazioni di condivisione
Go to UPS settings=Vai alle impostazioni dell'UPS
Go to User settings=Vai alle impostazioni dell'utente
Go to VM settings=Vai alle impostazioni VM
Go to VPN settings=Vai alle impostazioni VPN
Handshake=negoziazione
has=ha
healthy=in salute
heat warning=avviso temperatura
Hide details=Nascondi dettagli
in progress=in corso
Inactive tunnels=Tunnel inattivi
inactive=inattivo
Inbound=In entrata
invalid device=dispositivo non valido
invalid devices=dispositivi non validi
Last check completed on %s=L'ultimo controllo completato il **%s**
Last check incomplete on %s=L'ultimo controllo incompleto su **%s**
Last checked on %s=L'ultimo controllo su **%s**
Maximum size=Dimensione massima
Mode of operation=Modalità di funzionamento
Next check scheduled on %s=Prossimo controllo programmato il **%s**
No docker containers defined=Nessun contenitore docker definito
No running docker containers=Nessun contenitore docker in funzione
No running virtual machines=Nessuna macchina virtuale in funzione
No shares present=Nessuna condivisione presente
No virtual machines defined=Nessuna macchina virtuale definita
Nominal power=Potenza nominale
not received=non ricevuto
Outbound=In uscita
Overall Load=Carico complessivo
Parity disk not present=Disco di parità non presente
Parity disks not present=Dischi di parità non presenti
Parity has not been checked yet=La parità non è stata ancora verificata
Parity is degraded=La parità è degradata
Power=Potenza
Put system to sleep=
Reboot the system=
Receive counters=
Received packets=
Runtime left=
Scheduled parity check is disabled=
Select Case Model=
Share count %s with %s cache only and %s encrypted=Share count: %s with %s cache only and %s encrypted
Show details=
Show Information=
Shutdown the system=
SMART error=
SMART=
sn=s/n
Start the array=
Started only=
Stop the array=
This will put the system to sleep=
This will reboot the system=
This will shutdown the system=
This will start the array=
This will stop the array=
Transmit counters=
Transmitted packets=
UPS Load=
UPS status=
Usable size=
User count %s with %s unprotected=User count: %s with %s unprotected
utilization warning=
View Running Processes=
Virtual Machines=
